api for brand create -> Post method "/local/brand/create"
api for brand update -> Post method "/local/brand/update"
api for brand read all -> Get method "/local/brand/read"
api for brand read -> Get method "/local/brand/read/:id"
api for brand delete -> Get method "/local/brand/delete/:id"

api for category create -> Post method "/local/category/create"
api for category update -> Post method "/local/category/update"
api for category read all -> Get method "/local/category/read"
api for category read -> Get method "/local/category/read/:id"
api for category delete -> Get method "/local/category/delete/:id"

api for role create -> Post method "/local/role/create"
api for role update -> Post method "/local/role/update"
api for role read all -> Get method "/local/role/read"
api for role read -> Get method "/local/role/read/:id"
api for role delete -> Get method "/local/role/delete/:id"

api for status create -> Post method "/local/status/create"
api for status update -> Post method "/local/status/update"
api for status read all -> Get method "/local/status/read"
api for status read -> Get method "/local/status/read/:id"
api for status delete -> Get method "/local/status/delete/:id"

api for user create -> Post method "/local/user/create"
api for user update -> Post method "/local/user/update"
api for user read all -> Get method "/local/user/read"
api for user read -> Get method "/local/user/read/:id"
api for user delete -> Get method "/local/user/delete/:id"

api for project create -> Post method "/local/project/create"
api for project update -> Post method "/local/project/update"
api for project read all -> Get method "/local/project/read"
api for project read -> Get method "/local/project/read/:id"
api for project delete -> Get method "/local/project/delete/:id"

api for task create -> Post method "/local/task/create"
api for task update -> Post method "/local/task/update"
api for task read all -> Get method "/local/task/read"
api for task read -> Get method "/local/task/read/:id"
api for task delete -> Get method "/local/task/delete/:id"

